(map
 (terrain
  (G G G G G G G G G G H3 G G G G G G G G G G G G G G G G G G G G G)
  (G G G G G G G G G G H2 G G G G G G G G G G G G G G G G G G G G G)
  (G G G G G G G G G G G G G G G G G G G G G G G G G G G G G G G G)
  (G G G G G G G G G G G G G G G G G G G G G G G G G G G G G G G G)
  (G G G G G G G M M G G G G G G G G G G G G G G G G G G G G G G G)
  (G G G G G G G M M G G G G G G G G G G G G G G G G G G G G G G G)
  (G G G G G G G M M G G G G G G G G G G G G G G G G G G G G G G G)
  (G G G G G G G M M G G G G G G G G G G G G G G G G G G G G G G G)
  (G G G G G G G M M G G G G G G G G G G G G G G G G G G G G G G G)
  (G G G G G G G M M G G G G G G G G G G G G G G G G G G G G G G G)
  (G G G G G G G M M G G G G G G G G G G G G G G G G G G G G G G G)
  (G G G G G G G M M G G G G G G G G G G G G G G G G G G G G G G G)
  (G G G G G G G G G G G G G G G G G G G G G G G G G G G G G G G G)
  (G G G G G G G G G G G G G G G G G G G G G G G G G G G G G G G G)
  (G G G G G G G G G G G G G G G G G G G G G G G G G G G G G G G G)
  (G G G G G G G G G G G G G G G G G G G G G G G G G G G G G G G G)
  (G G G G G G G G G G G G G G G G G G G G G G M M G G G G G G G G)
  (G G G G G G G G G G G G G G G G G G G G G G M M G G G G G G G G)
  (G G G G G G G G G G G G G G G G G G G G G G M M G G G G G G G G)
  (G G G G G G G G G G G G G G G G G G G G G G M M G G G G G G G G)
  (G G G G G G G G G G G G G G G G G G G G G G M M G G G G G G G G)
  (G G G G G G G G G G G G G G G G G G G G G G M M G G G G G G G G)
  (G G G G G G G G G G G G G G G G G G G G G G M M G G G G G G G G)
  (G G G G G G G G G G G G G G G G G G G G G G M M G G G G G G G G)
  (H4 H4 H4 H4 H4 H4 H4 H4 H4 H4 H4 H4 H4 H4 H4 H4 H4 H4 H4 H4 H4 H4 H5 G G G G G G G G G)
  (G G G G G G G G G G G G G G G G G G G G G G G G G G G G G G G G)
  (G G G G G G G G G G G G G G G G G G G G G G G G G G G G G G G G)
  (G G G G G G G G G G G G G G G G G G G G G G G G G G G G G G G G)
  (G G G G G G G G G G G G G G G G G G G G G G G G G G G G G G G G)
  (G G G G G G G G G G G G G G G G G G G G G G G G G G G G G G G G)
  (G G G G G G G G G G G G G G G G G G G G G G G G G G G G G G G G)
  (G G G G G G G G G G G G G G G G G G G G G G G G G G G G G G G G)
  (G G G G G G G G G G G G G G G G G G G G G G G G G G G G G G G G)
  (G G G G G G G G G G H3 G G G G G G G G G G G G G G G G G G G G G)
  (G G G G G G G G G G H2 G G G G G G G G G G G G G G G G G G G G G)
  (G G G G G G G G G G G G G G G G G G G G G G G G G G G G G G G G)
  (G G G G G G G G G G G G G G G G G G G G G G G G G G G G G G G G)
  (G G G G G G G M M G G G G G G G G G G G G G G G G G G G G G G G)
  (G G G G G G G M M G G G G G G G G G G G G G G G G G G G G G G G)
  (G G G G G G G M M G G G G G G G G G G G G G G G G G G G G G G G)
  (G G G G G G G M M G G G G G G G G G G G G G G G G G G G G G G G)
  (G G G G G G G M M G G G G G G G G G G G G G G G G G G G G G G G)
  (G G G G G G G M M G G G G G G G G G G G G G G G G G G G G G G G)
  (G G G G G G G M M G G G G G G G G G G G G G G G G G G G G G G G)
  (G G G G G G G M M G G G G G G G G G G G G G G G G G G G G G G G)
  (G G G G G G G G G G G G G G G G G G G G G G G G G G G G G G G G)
  (G G G G G G G G G G G G G G G G G G G G G G G G G G G G G G G G)
  (G G G G G G G G G G G G G G G G G G G G G G G G G G G G G G G G)
  (G G G G G G G G G G G G G G G G G G G G G G G G G G G G G G G G)
  (G G G G G G G G G G G G G G G G G G G G G G M M G G G G G G G G)
  (G G G G G G G G G G G G G G G G G G G G G G M M G G G G G G G G)
  (G G G G G G G G G G G G G G G G G G G G G G M M G G G G G G G G)
  (G G G G G G G G G G G G G G G G G G G G G G M M G G G G G G G G)
  (G G G G G G G G G G G G G G G G G G G G G G M M G G G G G G G G)
  (G G G G G G G G G G G G G G G G G G G G G G M M G G G G G G G G)
  (G G G G G G G G G G G G G G G G G G G G G G M M G G G G G G G G)
  (H4 H4 H4 H4 H4 H4 H4 H4 H4 H4 H4 H4 H4 H4 H4 H4 H4 H4 H4 H4 H4 H4 H5 G G G G G G G G G)
  (G G G G G G G G G G G G G G G G G G G G G G G G G G G G G G G G)
  (G G G G G G G G G G G G G G G G G G G G G G G G G G G G G G G G)
  (G G G G G G G G G G G G G G G G G G G G G G G G G G G G G G G G)
  (G G G G G G G G G G G G G G G G G G G G G G G G G G G G G G G G)
  (G G G G G G G G G G G G G G G G G G G G G G G G G G G G G G G G)
  (G G G G G G G G G G G G G G G G G G G G G G G G G G G G G G G G)
  (G G G G G G G G G G G G G G G G G G G G G G G G G G G G G G G G))
 (buildings
  (factory 0 7.0 phasers)
  (factory 4 7.0 missiles)
  (factory 0 11.0 nuclear)
  (factory 4 11.0 chassis)
  (factory 28 54 phasers)
  (factory 24 54 missiles)
  (factory 28 50 nuclear)
  (factory 24 50 chassis)
  (factory 14 48 chassis)
  (factory 14 51 nuclear)
  (factory 14 45 nuclear)
  (factory 17 48 phasers)
  (factory 11 48 phasers)
  (warbase 1.5 2 1)
  (warbase 27.5 29 2)
  (warbase 1.5 29 2)
  (warbase 1.5 61 2)))
